RRRRRRRRRRRRRRR
R@...G..G.....R
R.L.L.LGL.L.L.R
R..G...G..G...R
R.L.L.L.L.L.L.R
R........G....R
R.L.LGLGL.L.L.R
R..G.....G....R
R.L.L.L.L.L.L.R
R..G.....G....R
R.L.L.L.L.L.L.R
R...G...G....ZR
RRRRRRRRRRRRRRR